11111111111111
11111110000000
00000001111111
11111110000000
00000001111111