11111111111
11111110000
00000001111
11111110000
00000001111